##################################
#                                #
#          O                     #
#  O               O     #
#                X               #
#O                               #
#########X                       #
#                        #########
#                                #
#           X   O                #
#                         ########
#     X                          #
#                   X            #
#P                               #
##################################
