########
#   P   #
####  X #
##O     #
#######