############
#          #
#          #
# PXO    ###
#          #
# OX       #
############
